0000000000000001000000000000000100000000000000010000000000000001
0
0
0
0
0
1111111111111111111111111100000000000111111111111111111111111111
0
0000000000000000000000011111111111111111
000000000111111111111000000000000000000000011111111111
0
1111111110000000000000000011100000111000000000000000000111111111
0000000000000000000000000000000000000000000000000000000000000000
1111111111111111111111111111100000111111111111111111111111111111
0
000000000000000000000000000000111